#######################################
# Datatypes (KEYWORD1)
#######################################

#AT Command Header

ATCMD_NetworkStatus	KEYWORD1
ATCMD_NetworkScanEntry	KEYWORD1
ATCMD_NetworkStatus	KEYWORD1
ATCMD_WPSResult		KEYWORD1
ATCMD_MQTTparams	KEYWORD1

ATCMD_FSM_E	KEYWORD1
ATCMD_RESP_E	KEYWORD1
ATCMD_MODE_E	KEYWORD1
ATCMD_PSAVE_E	KEYWORD1
ATCMD_REGDOMAIN_E	KEYWORD1
ATCMD_SECURITYMODE_E	KEYWORD1
ATCMD_SOCKET_OPTION_TYPE_E	KEYWORD1
ATCMD_SOCKET_OPTION_PARAM_E	KEYWORD1
ATCMD_HTTP_HEADER_E		KEYWORD1
ATCMD_HTTP_METHOD_E		KEYWORD1

#GS2000Hal Header
SPI_RESP_STATUS_E	KEYWORD1

#######################################
# Methods and Functions (KEYWORD2)
#######################################

#AT Command Header

AtCmd_Init	KEYWORD2
AtCmd_AT	KEYWORD2
AtCmd_VER	KEYWORD2
AtCmd_ATE	KEYWORD2
AtCmd_RESET	KEYWORD2
AtCmd_NMAC_Q	KEYWORD2
AtCmd_WRXACTIVE	KEYWORD2
AtCmd_WRXPS	KEYWORD2
AtCmd_BDATA	KEYWORD2
AtCmd_WREGDOMAIN_Q	KEYWORD2
AtCmd_WREGDOMAIN	KEYWORD2
AtCmd_WM	KEYWORD2
AtCmd_WSEC	KEYWORD2
AtCmd_WPAPSK	KEYWORD2
AtCmd_WA	KEYWORD2
AtCmd_WWPS	KEYWORD2
AtCmd_WSTATUS	KEYWORD2
AtCmd_WD	KEYWORD2
AtCmd_NDHCP	KEYWORD2
AtCmd_DHCPSRVR	KEYWORD2
AtCmd_NSET	KEYWORD2
AtCmd_NSTAT	KEYWORD2
AtCmd_NCTCP	KEYWORD2
AtCmd_NCUDP	KEYWORD2
AtCmd_NSTCP	KEYWORD2
AtCmd_NSUDP	KEYWORD2
AtCmd_NCLOSE	KEYWORD2
AtCmd_NCLOSEALL	KEYWORD2
AtCmd_PSDPSLEEP	KEYWORD2
AtCmd_PSSTBY	KEYWORD2
AtCmd_STORENWCONN	KEYWORD2
AtCmd_RESTORENWCONN	KEYWORD2
AtCmd_SendCommand	KEYWORD2
AtCmd_checkResponse	KEYWORD2
AtCmd_ParseRcvData	KEYWORD2
AtCmd_RecvResponse	KEYWORD2
AtCmd_SendBulkData	KEYWORD2
AtCmd_UDP_SendBulkData	KEYWORD2
WaitForTCPConnection	KEYWORD2
AtCmd_MQTTCONNECT	KEYWORD2
AtCmd_MQTTPUBLISH	KEYWORD2
AtCmd_HTTPOPEN	KEYWORD2
AtCmd_HTTPCONF	KEYWORD2
AtCmd_HTTPSEND	KEYWORD2
AtCmd_HTTPCLOSE	KEYWORD2
AtCmd_DNSLOOKUP	KEYWORD2
AtCmd_APCLIENTINFO	KEYWORD2

#GS2000Hal Header
msDelta	KEYWORD2
Init_GS2200_SPI	KEYWORD2
Get_GPIO37Status	KEYWORD2
WiFi_Write	KEYWORD2
WiFi_Read	KEYWORD2
WiFi_InitESCBuffer	KEYWORD2
WiFi_StoreESCBuffer	KEYWORD2
Check_CID	KEYWORD2
ConsoleLog	KEYWORD2
ConsoleByteSend	KEYWORD2
ConsolePrintf	KEYWORD2


#######################################
# Instances(KEYWORD2)
#######################################

#######################################
# Class members(KEYWORD2)
#######################################


#######################################
# Constants(LITERAL1)
#######################################

#AT Command Header

ATCMD_INVALID_CID        	LITERAL1
ATCMD_BSSID_MAX_LENGTH   	LITERAL1
ATCMD_SSID_MAX_LENGTH    	LITERAL1
ATCMD_MAC_MAX_LENGTH     	LITERAL1
ATCMD_PASSWORD_MAX_LENGTH	LITERAL1

ATCMD_CR	LITERAL1
ATCMD_LF	LITERAL1
ATCMD_ESC	LITERAL1

ATCMD_FSM_START		LITERAL1
ATCMD_FSM_RESPONSE	LITERAL1
ATCMD_FSM_ESC_START	LITERAL1
ATCMD_FSM_BULK_DATA	LITERAL1
ATCMD_FSM_UDP_BULK_DATA	LITERAL1

ATCMD_RESP_UNMATCH	LITERAL1
ATCMD_RESP_OK		LITERAL1
ATCMD_RESP_INVALID_INPUT	LITERAL1
ATCMD_RESP_INVALID_CID	LITERAL1
ATCMD_RESP_ERROR	LITERAL1
ATCMD_RESP_ERROR_SOCKET_FAILURE	LITERAL1
ATCMD_RESP_DISCONNECT	LITERAL1
ATCMD_RESP_DISASSOCIATION_EVENT	LITERAL1
ATCMD_RESP_OUT_OF_STBY_ALARM	LITERAL1
ATCMD_RESP_OUT_OF_STBY_TIMER	LITERAL1
ATCMD_RESP_OUT_OF_DEEP_SLEEP	LITERAL1
ATCMD_RESP_ERROR_IP_CONFIG_FAIL	LITERAL1
ATCMD_RESP_NORMAL_BOOT_MSG	LITERAL1
ATCMD_RESP_RESET_WLAN_WD	LITERAL1
ATCMD_RESP_RESET_APP_WD		LITERAL1
ATCMD_RESP_RESET_WLAN_SW	LITERAL1
ATCMD_RESP_RESET_APP_SW		LITERAL1
ATCMD_RESP_RESET_WLAN_EXCEPT	LITERAL1
ATCMD_RESP_EXTERNAL_RESET	LITERAL1
ATCMD_RESP_RESPONSE_TIMEOUT	LITERAL1
ATCMD_RESP_BULK_DATA_RX		LITERAL1
ATCMD_RESP_UDP_BULK_DATA_RX	LITERAL1
ATCMD_RESP_ESC_OK	LITERAL1
ATCMD_RESP_ESC_FAIL	LITERAL1
ATCMD_RESP_TCP_SERVER_CONNECT	LITERAL1
ATCMD_RESP_TIMEOUT	LITERAL1
ATCMD_RESP_NO_MORE_MEMORY	LITERAL1
ATCMD_RESP_ERROR_BUFFER_HANDLING	LITERAL1
ATCMD_RESP_SPI_ERROR	LITERAL1
ATCMD_RESP_INPUT_TOO_LONG	LITERAL1

HTTP_HEADER_AUTHORIZATION	LITERAL1
HTTP_HEADER_CONNECTION	LITERAL1
HTTP_HEADER_CONTENT_ENCODING	LITERAL1
HTTP_HEADER_CONTENT_LENGTH	LITERAL1
HTTP_HEADER_CONTENT_RANGE	LITERAL1
HTTP_HEADER_CONTENT_TYPE	LITERAL1
HTTP_HEADER_DATE	LITERAL1
HTTP_HEADER_EXPIRES	LITERAL1
HTTP_HEADER_FROM	LITERAL1
HTTP_HEADER_HOST	LITERAL1
HTTP_HEADER_IF_MODIFIED_SINCE	LITERAL1
HTTP_HEADER_LAST_MODIFIED	LITERAL1
HTTP_HEADER_LOCATION	LITERAL1
HTTP_HEADER_PRAGMA	LITERAL1
HTTP_HEADER_RANGE	LITERAL1
HTTP_HEADER_REFERER	LITERAL1
HTTP_HEADER_SERVER	LITERAL1
HTTP_HEADER_TRANSFER_ENCODING	LITERAL1
HTTP_HEADER_USER_AGENT	LITERAL1
HTTP_HEADER_WWW_AUTHENTICATE	LITERAL1
HTTP_REQUEST_URL	LITERAL1

#GS2000Hal Header
SPI_RESP_STATUS_OK	LITERAL1
SPI_RESP_STATUS_ERROR	LITERAL1
SPI_RESP_STATUS_TIMEOUT	LITERAL1

